############
#...#......#
s.#.#.####.#
###.#......#
#....###.#.#
####.#.#.#.#
#..#.#.#.#.#
##.#.#.#.#.#
#........#.#
######.###.x
#......#...#
############